TOTAL	Insgesamt - Alle Waren
SITC0-4	Primärerzeugnisse
SITC0-4A	Primärerzeugnisse außer SITC Abschnitt 33
SITC0_1	Nahrungsmittel, Getränke und Tabak
SITC0	Nahrungsmittel und lebende Tiere
SITC1	Getränke und Tabak
SITC2_4	Grundstoffe
SITC2	Rohstoffe (ausgenommen Nahrungsmittel und mineralische Brennstoffe)
SITC3	Mineralische Brennstoffe, Schmiermittel und verwandte Erzeugnisse
SITC33	Erdöl, Erdölerzeugnisse und verwandte Waren
SITC4	Tierische und pflanzliche Öle, Fette und Wachse
SITC5-8	Bearbeitete Waren
SITC5	Chemische Erzeugnisse, a.n.g.
SITC6_8	Sonstige bearbeitete Waren
SITC6	Bearbeitete Waren, vorwiegend nach Beschaffenheit gegliedert
SITC7	Maschinenbauerzeugnisse und Fahrzeuge
SITC8	Verschiedene Fertigwaren
SITC9	Waren und Warenverkehrsvorgänge, anderweitig in der SITC nicht erfasst
TOT_HT	Hochtechnologieprodukte insgesamt
AER	Luft- und Raumfahrt
COM	Computer und Büromaschinen
ELT	Elektronik - Telekommunikation
PHA	Pharmazeutische Produkte
SCI	Wissenschaftliche Instrumente
ELM	Elektrische Maschinen
CHE	Chemie
NEM	Nicht elektrische Maschinen
ARM	Waffen
